---#--###--#@
-#---#----##-
####-#-#-#@##
---#---#-#---
-#-####---##-
-#------#----
-############
-------------